001021222
001022222
001022222
001104000
000114100
220001100
222001100
222001100