432243124
412214134
401041043
130144021
232131341
423134233
423100144
424004223
321404004
