0330310322
1142302314
2433321030
2300403221
2110003301
4423304114
2434032344
2113133023
4113324334
4314220102
