4444444444444444
4444444444444444
4444444444444444
4444111444444444
4444111444444444
4444444444144444
4444444444144444
4444444444444444
4444444444144444
4444444444144444
4444444444444444