4444444444444444
4444444444444444
4444444444444444
4444111111444444
4444100001444444
4444111111144444
4444444444144444
4444444444144444
4444444444144444
4444444444144444
4444444444444444