00102222440022
00102222440001
00102222440011
00110000440110
00011111221100
22000100443333
22200100443333
22200100443333
