0000222200
0000222200
0000222200
0000222200
0000000000
0010222200
0010222200
0010222200
0011000000
0001110000
2201010011
2221110111
2220010011